 , ,t3,-, , , ,-, , , 
t5, , ,-,c6, , ,-,c2, , 
 , , ,-, , , ,d4,i, , 
-,-,-,-,-,-,-,-,-,-,-
t2, , ,-,x,t5, ,-, , , 
 , , ,-, , , ,-,k1, , 
 , , ,-, , , ,-, ,t3, 
-,-,-,-,-,-,-,-,-,-,d1
 ,k5, ,-, , , ,-,k6, , 
 , , ,-, , , ,d2, , , 
 , , ,-, , , ,-,k2, , 
