 , ,t6,-, , , ,-, , , 
k5, , ,-,k2, , ,-, , , 
k1,k4,i,d5, , , ,d2, , ,c3
-,d4,-,-,-,-,-,-,-,-,-
 ,k6, ,-, , , ,-, , , 
 , , ,-,c2, , ,-, , , 
 , , ,-, , , ,-, , , 
-,d6,-,-,-,-,-,-,-,-,-
 , , ,-, , , ,-, , ,c6
 , ,c5,-, , ,x,-, , , 
 , , ,-, , , ,-, , , 
